9
NODE 0 VARIABLE 0
NODE 1 VARIABLE 1
NODE 2 VARIABLE 2
NODE 3 SPLIT 3
NODE 4 NOT 4
NODE 5 OR 6
NODE 6 AND 5
NODE 7 OR 7
NODE 8 END 10
30 23
_	_	_	_	_	_	_	_	_	_	_	_	_	_	_	_	_	_	_	_	_	_	_	_	_	_	_	_	_	_	_	_	_	_	_	_	_	_	_	_	_	_	_	_	_	_	_	_	_	_	_	_	_	_	_	_	_	_	_	_	_	_	_	_	_	_	_	_	_	_	_	_	_	_	_	_	_	_	_	_	_	_	_	_	_	_	_	_	_	_
_	E	_	_	T	>	>	W	>	>	W	>	>	W	>	>	W	>	>	W	>	>	W	>	>	W	>	>	W	>	>	W	>	>	W	>	>	W	>	>	W	>	>	W	>	>	W	>	>	W	>	>	W	>	>	W	>	>	W	>	>	W	>	>	W	>	>	W	>	>	W	>	>	W	>	>	T	_	_	E	_	_	E	_	_	E	_	_	E	_
_	_	_	_	^	_	_	_	_	_	_	_	_	_	_	_	_	_	_	_	_	_	_	_	_	_	_	_	_	_	_	_	_	_	_	_	_	_	_	_	_	_	_	_	_	_	_	_	_	_	_	_	_	_	_	_	_	_	_	_	_	_	_	_	_	_	_	_	_	_	_	_	_	_	_	_	V	_	_	_	_	_	_	_	_	_	_	_	_	_
_	_	_	_	^	_	_	_	_	_	_	_	_	_	_	_	_	_	_	_	_	_	_	_	_	_	_	_	_	_	_	_	_	_	_	_	_	_	_	_	_	_	_	_	_	_	_	_	_	_	_	_	_	_	_	_	_	_	_	_	_	_	_	_	_	_	_	_	_	_	_	_	_	_	_	_	V	_	_	_	_	_	_	_	_	_	_	_	_	_
_	E	_	_	W	_	_	E	_	_	E	_	_	E	_	_	E	_	_	E	_	_	E	_	_	E	_	_	E	_	_	E	_	_	E	_	_	E	_	_	E	_	_	E	_	_	E	_	_	E	_	_	E	_	_	E	_	_	E	_	_	E	_	_	E	_	_	E	_	_	E	_	_	E	_	_	W	_	_	E	_	_	E	_	_	E	_	_	E	_
_	_	_	_	^	_	_	_	_	_	_	_	_	_	_	_	_	_	_	_	_	_	_	_	_	_	_	_	_	_	_	_	_	_	_	_	_	_	_	_	_	_	_	_	_	_	_	_	_	_	_	_	_	_	_	_	_	_	_	_	_	_	_	_	_	_	_	_	_	_	_	_	_	_	_	_	V	_	_	_	_	_	_	_	_	_	_	_	_	_
_	_	_	_	^	_	_	_	_	_	_	_	_	_	_	_	_	_	_	_	_	_	_	_	_	_	_	_	_	_	_	_	_	_	_	_	_	_	_	_	_	_	_	_	_	_	_	_	_	_	_	_	_	_	_	_	_	_	_	_	_	_	_	_	_	_	_	_	_	_	_	_	_	_	_	_	V	_	_	_	_	_	_	_	_	_	_	_	_	_
_	E	_	_	W	_	_	E	_	_	T	>	>	W	>	>	W	>	>	W	>	>	W	>	>	W	>	>	W	>	>	W	>	>	W	>	>	W	>	>	W	>	>	W	>	>	W	>	>	W	>	>	T	_	_	E	_	_	E	_	_	E	_	_	E	_	_	E	_	_	E	_	_	E	_	_	W	_	_	E	_	_	E	_	_	E	_	_	E	_
_	_	_	_	^	_	_	_	_	_	^	_	_	_	_	_	_	_	_	_	_	_	_	_	_	_	_	_	_	_	_	_	_	_	_	_	_	_	_	_	_	_	_	_	_	_	_	_	_	_	_	_	V	_	_	_	_	_	_	_	_	_	_	_	_	_	_	_	_	_	_	_	_	_	_	_	V	_	_	_	_	_	_	_	_	_	_	_	_	_
_	_	_	_	^	_	_	_	_	_	^	_	_	_	_	_	_	_	_	_	_	_	_	_	_	_	_	_	_	_	_	_	_	_	_	_	_	_	_	_	_	_	_	_	_	_	_	_	_	_	_	_	V	_	_	_	_	_	_	_	_	_	_	_	_	_	_	_	_	_	_	_	_	_	_	_	V	_	_	_	_	_	_	_	_	_	_	_	_	_
_	E	_	_	W	_	_	E	_	_	W	_	_	E	_	_	E	_	_	E	_	_	E	_	_	E	_	_	E	_	_	E	_	_	E	_	_	E	_	_	E	_	_	E	_	_	E	_	_	E	_	_	W	_	_	E	_	_	E	_	_	E	_	_	E	_	_	E	_	_	E	_	_	E	_	_	W	_	_	E	_	_	E	_	_	E	_	_	E	_
_	_	_	_	^	_	_	_	_	_	^	_	_	_	_	_	_	_	_	_	_	_	_	_	_	_	_	_	_	_	_	_	_	_	_	_	_	_	_	_	_	_	_	_	_	_	_	_	_	_	_	_	V	_	_	_	_	_	_	_	_	_	_	_	_	_	_	_	_	_	_	_	_	_	_	_	V	_	_	_	_	_	_	_	_	_	_	_	_	_
_	_	_	_	^	_	_	_	_	_	^	_	_	_	_	_	_	_	_	_	_	_	_	_	_	_	_	_	_	_	_	_	_	_	_	_	_	_	_	_	_	_	_	_	_	_	_	_	_	_	_	_	V	_	_	_	_	_	_	_	_	_	_	_	_	_	_	_	_	_	_	_	_	_	_	_	V	_	_	_	_	_	_	_	_	_	_	_	_	_
_	E	_	_	W	_	_	E	_	_	T	<	<	W	<	<0	P0	_	_	E	_	_	T	>	>	W	>	>	W	>	>	W	>	>	W	>	>	W	>	>0	P4	>0	>	W	>	>	T	_	_	E	_	_	W	_	_	E	_	_	E	_	_	E	_	_	E	_	_	E	_	_	E	_	_	E	_	_	W	_	_	E	_	_	E	_	_	E	_	_	E	_
_	_	_	_	^	_	_	_	_	_	_	_	_	_	_	_	_	_	_	_	_	_	^	_	_	_	_	_	_	_	_	_	_	_	_	_	_	_	_	_	_	_	_	_	_	_	V	_	_	_	_	_	V	_	_	_	_	_	_	_	_	_	_	_	_	_	_	_	_	_	_	_	_	_	_	_	V	_	_	_	_	_	_	_	_	_	_	_	_	_
_	_	_	_	^	_	_	_	_	_	_	_	_	_	_	_	_	_	_	_	_	_	^	_	_	_	_	_	_	_	_	_	_	_	_	_	_	_	_	_	_	_	_	_	_	_	V	_	_	_	_	_	V	_	_	_	_	_	_	_	_	_	_	_	_	_	_	_	_	_	_	_	_	_	_	_	V	_	_	_	_	_	_	_	_	_	_	_	_	_
_	E	_	_	W	_	_	E	_	_	E	_	_	E	_	_	E	_	_	E	_	_	W	_	_	E	_	_	E	_	_	E	_	_	E	_	_	E	_	_	E	_	_	E	_	_	W	_	_	E	_	_	W	_	_	E	_	_	E	_	_	E	_	_	E	_	_	E	_	_	E	_	_	E	_	_	W	_	_	E	_	_	E	_	_	E	_	_	E	_
_	_	_	_	^	_	_	_	_	_	_	_	_	_	_	_	_	_	_	_	_	_	^	_	_	_	_	_	_	_	_	_	_	_	_	_	_	_	_	_	_	_	_	_	_	_	V	_	_	_	_	_	V	_	_	_	_	_	_	_	_	_	_	_	_	_	_	_	_	_	_	_	_	_	_	_	V	_	_	_	_	_	_	_	_	_	_	_	_	_
_	_	_	_	^	_	_	_	_	_	_	_	_	_	_	_	_	_	_	_	_	_	^	_	_	_	_	_	_	_	_	_	_	_	_	_	_	_	_	_	_	_	_	_	_	_	VV	_	_	_	_	_	VV	_	_	_	_	_	_	_	_	_	_	_	_	_	_	_	_	_	_	_	_	_	_	_	V	_	_	_	_	_	_	_	_	_	_	_	_	_
_	E	_	_	T	<	<	W	<	<	W	<	<	W	<	<0	P1	_	_	E	_	_	W	_	_	E	_	_	E	_	_	E	_	_	E	_	_	E	_	_	T	>	>	W	>	>	C	>	>	W	>	>	C	>	>	W	>	>	W	>	>	W	>	>	W	>	>	W	>	>>0	P6	<1	<	W	<	<	T	_	_	E	_	_	E	_	_	E	_	_	E	_
_	_	_	_	_	_	_	_	_	_	_	_	_	_	_	_	_	_	_	_	_	_	^	_	_	_	_	_	_	_	_	_	_	_	_	_	_	_	_	_	^	_	_	_	_	_	VV	_	_	_	_	_	VV	_	_	_	_	_	_	_	_	_	_	_	_	_	_	_	_	_	V0	_	_	_	_	_	_	_	_	_	_	_	_	_	_	_	_	_	_	_
_	_	_	_	_	_	_	_	_	_	_	_	_	_	_	_	_	_	_	_	_	_	^	_	_	_	_	_	_	_	_	_	_	_	_	_	_	_	_	_	^	_	_	_	_	_	V	_	_	_	_	_	V	_	_	_	_	_	_	_	_	_	_	_	_	_	_	_	_	_	V	_	_	_	_	_	_	_	_	_	_	_	_	_	_	_	_	_	_	_
_	E	_	_	E	_	_	E	_	_	E	_	_	E	_	_	E	_	_	E	_	_	W	_	_	E	_	_	E	_	_	E	_	_	E	_	_	E	_	_	W	_	_	E	_	_	W	_	_	E	_	_	W	_	_	E	_	_	E	_	_	E	_	_	E	_	_	E	_	_	W	_	_	E	_	_	E	_	_	E	_	_	E	_	_	E	_	_	E	_
_	_	_	_	_	_	_	_	_	_	_	_	_	_	_	_	_	_	_	_	_	_	^	_	_	_	_	_	_	_	_	_	_	_	_	_	_	_	_	_	^	_	_	_	_	_	V	_	_	_	_	_	V	_	_	_	_	_	_	_	_	_	_	_	_	_	_	_	_	_	V	_	_	_	_	_	_	_	_	_	_	_	_	_	_	_	_	_	_	_
_	_	_	_	_	_	_	_	_	_	_	_	_	_	_	_	_	_	_	_	_	_	^	_	_	_	_	_	_	_	_	_	_	_	_	_	_	_	_	_	^	_	_	_	_	_	V	_	_	_	_	_	V	_	_	_	_	_	_	_	_	_	_	_	_	_	_	_	_	_	V	_	_	_	_	_	_	_	_	_	_	_	_	_	_	_	_	_	_	_
_	T	<	<	W	<	<	W	<	<	W	<	<	W	<	<0	P2	_	_	E	_	_	W	_	_	E	_	_	E	_	_	E	_	_	E	_	_	E	_	_	W	_	_	E	_	_	W	_	_	E	_	_	W	_	_	E	_	_	E	_	_	E	_	_	E	_	_	E	_	_	W	_	_	E	_	_	E	_	_	E	_	_	E	_	_	E	_	_	E	_
_	V	_	_	_	_	_	_	_	_	_	_	_	_	_	_	_	_	_	_	_	_	^	_	_	_	_	_	_	_	_	_	_	_	_	_	_	_	_	_	^	_	_	_	_	_	V	_	_	_	_	_	V	_	_	_	_	_	_	_	_	_	_	_	_	_	_	_	_	_	V	_	_	_	_	_	_	_	_	_	_	_	_	_	_	_	_	_	_	_
_	V	_	_	_	_	_	_	_	_	_	_	_	_	_	_	_	_	_	_	_	_	^	_	_	_	_	_	_	_	_	_	_	_	_	_	_	_	_	_	^	_	_	_	_	_	V	_	_	_	_	_	V	_	_	_	_	_	_	_	_	_	_	_	_	_	_	_	_	_	V	_	_	_	_	_	_	_	_	_	_	_	_	_	_	_	_	_	_	_
_	W	_	_	E	_	_	E	_	_	E	_	_	E	_	_	E	_	_	E	_	_	W	_	_	E	_	_	E	_	_	E	_	_	E	_	_	E	_	_	W	_	_	E	_	_	W	_	_	E	_	_	W	_	_	E	_	_	E	_	_	E	_	_	E	_	_	E	_	_	W	_	_	E	_	_	E	_	_	E	_	_	E	_	_	E	_	_	E	_
_	V	_	_	_	_	_	_	_	_	_	_	_	_	_	_	_	_	_	_	_	_	^	_	_	_	_	_	_	_	_	_	_	_	_	_	_	_	_	_	^	_	_	_	_	_	V	_	_	_	_	_	V	_	_	_	_	_	_	_	_	_	_	_	_	_	_	_	_	_	V	_	_	_	_	_	_	_	_	_	_	_	_	_	_	_	_	_	_	_
_	V	_	_	_	_	_	_	_	_	_	_	_	_	_	_	_	_	_	_	_	_	^	_	_	_	_	_	_	_	_	_	_	_	_	_	_	_	_	_	^	_	_	_	_	_	V	_	_	_	_	_	V	_	_	_	_	_	_	_	_	_	_	_	_	_	_	_	_	_	V	_	_	_	_	_	_	_	_	_	_	_	_	_	_	_	_	_	_	_
_	W	_	_	E	_	_	E	_	_	E	_	_	E	_	_	T	>	>	W	>	>>	C	>>	>	W	>	>	W	>	>	W	>	>	W	>	>	W	>	>	T	_	_	E	_	_	W	_	_	E	_	_	W	_	_	E	_	_	E	_	_	E	_	_	E	_	_	E	_	_	W	_	_	E	_	_	E	_	_	E	_	_	E	_	_	E	_	_	E	_
_	V	_	_	_	_	_	_	_	_	_	_	_	_	_	_	^	_	_	_	_	_	^	_	_	_	_	_	_	_	_	_	_	_	_	_	_	_	_	_	_	_	_	_	_	_	V	_	_	_	_	_	V	_	_	_	_	_	_	_	_	_	_	_	_	_	_	_	_	_	V	_	_	_	_	_	_	_	_	_	_	_	_	_	_	_	_	_	_	_
_	V	_	_	_	_	_	_	_	_	_	_	_	_	_	_	^	_	_	_	_	_	^	_	_	_	_	_	_	_	_	_	_	_	_	_	_	_	_	_	_	_	_	_	_	_	V	_	_	_	_	_	V	_	_	_	_	_	_	_	_	_	_	_	_	_	_	_	_	_	V	_	_	_	_	_	_	_	_	_	_	_	_	_	_	_	_	_	_	_
_	W	_	_	E	_	_	E	_	_	E	_	_	E	_	_	W	_	_	E	_	_	W	_	_	E	_	_	E	_	_	E	_	_	E	_	_	E	_	_	E	_	_	E	_	_	W	_	_	E	_	_	W	_	_	E	_	_	E	_	_	E	_	_	E	_	_	E	_	_	W	_	_	E	_	_	E	_	_	E	_	_	E	_	_	E	_	_	E	_
_	V	_	_	_	_	_	_	_	_	_	_	_	_	_	_	^	_	_	_	_	_	^	_	_	_	_	_	_	_	_	_	_	_	_	_	_	_	_	_	_	_	_	_	_	_	V	_	_	_	_	_	V	_	_	_	_	_	_	_	_	_	_	_	_	_	_	_	_	_	V	_	_	_	_	_	_	_	_	_	_	_	_	_	_	_	_	_	_	_
_	V	_	_	_	_	_	_	_	_	_	_	_	_	_	_	^	_	_	_	_	_	^	_	_	_	_	_	_	_	_	_	_	_	_	_	_	_	_	_	_	_	_	_	_	_	V	_	_	_	_	_	V	_	_	_	_	_	_	_	_	_	_	_	_	_	_	_	_	_	V	_	_	_	_	_	_	_	_	_	_	_	_	_	_	_	_	_	_	_
_	W	_	_	E	_	_	E	_	_	E	_	_	E	_	_	W	_	_	E	_	_	W	_	_	E	_	_	T	<	<	W	<	<	W	<	<	W	<	<	W	<	<	W	<	<	T	_	_	E	_	_	W	_	_	E	_	_	E	_	_	E	_	_	E	_	_	E	_	_	W	_	_	E	_	_	E	_	_	E	_	_	E	_	_	E	_	_	E	_
_	V	_	_	_	_	_	_	_	_	_	_	_	_	_	_	^	_	_	_	_	_	^	_	_	_	_	_	V	_	_	_	_	_	_	_	_	_	_	_	_	_	_	_	_	_	_	_	_	_	_	_	V	_	_	_	_	_	_	_	_	_	_	_	_	_	_	_	_	_	V	_	_	_	_	_	_	_	_	_	_	_	_	_	_	_	_	_	_	_
_	V	_	_	_	_	_	_	_	_	_	_	_	_	_	_	^	_	_	_	_	_	^	_	_	_	_	_	V	_	_	_	_	_	_	_	_	_	_	_	_	_	_	_	_	_	_	_	_	_	_	_	V	_	_	_	_	_	_	_	_	_	_	_	_	_	_	_	_	_	V	_	_	_	_	_	_	_	_	_	_	_	_	_	_	_	_	_	_	_
_	W	_	_	E	_	_	E	_	_	E	_	_	E	_	_	W	_	_	E	_	_	W	_	_	E	_	_	W	_	_	E	_	_	E	_	_	E	_	_	E	_	_	E	_	_	E	_	_	E	_	_	W	_	_	E	_	_	E	_	_	E	_	_	E	_	_	E	_	_	W	_	_	E	_	_	E	_	_	E	_	_	E	_	_	E	_	_	E	_
_	V	_	_	_	_	_	_	_	_	_	_	_	_	_	_	^	_	_	_	_	_	^	_	_	_	_	_	V	_	_	_	_	_	_	_	_	_	_	_	_	_	_	_	_	_	_	_	_	_	_	_	V	_	_	_	_	_	_	_	_	_	_	_	_	_	_	_	_	_	V	_	_	_	_	_	_	_	_	_	_	_	_	_	_	_	_	_	_	_
_	V	_	_	_	_	_	_	_	_	_	_	_	_	_	_	^0	_	_	_	_	_	^	_	_	_	_	_	V	_	_	_	_	_	_	_	_	_	_	_	_	_	_	_	_	_	_	_	_	_	_	_	VV	_	_	_	_	_	_	_	_	_	_	_	_	_	_	_	_	_	V	_	_	_	_	_	_	_	_	_	_	_	_	_	_	_	_	_	_	_
_	T	>	>	W	>	>	W	>	>	W	>	>	W	>	>0	P3	_	_	E	_	_	W	_	_	E	_	_	W	_	_	E	_	_	T	<	<	W	<	<	W	<	<	W	<	<	W	<	<	W	<	<	C	<	<	W	<	<	W	<	<	W	<	<	W	<	<	W	<	<	T	_	_	E	_	_	E	_	_	E	_	_	E	_	_	E	_	_	E	_
_	_	_	_	_	_	_	_	_	_	_	_	_	_	_	_	VV1	_	_	_	_	_	^	_	_	_	_	_	V	_	_	_	_	_	V	_	_	_	_	_	_	_	_	_	_	_	_	_	_	_	_	_	VV	_	_	_	_	_	_	_	_	_	_	_	_	_	_	_	_	_	_	_	_	_	_	_	_	_	_	_	_	_	_	_	_	_	_	_	_	_
_	_	_	_	_	_	_	_	_	_	_	_	_	_	_	_	V	_	_	_	_	_	^	_	_	_	_	_	V	_	_	_	_	_	V	_	_	_	_	_	_	_	_	_	_	_	_	_	_	_	_	_	V	_	_	_	_	_	_	_	_	_	_	_	_	_	_	_	_	_	_	_	_	_	_	_	_	_	_	_	_	_	_	_	_	_	_	_	_	_
_	E	_	_	E	_	_	E	_	_	E	_	_	E	_	_	W	_	_	E	_	_	W	_	_	E	_	_	W	_	_	E	_	_	W	_	_	E	_	_	E	_	_	E	_	_	E	_	_	E	_	_	W	_	_	E	_	_	E	_	_	E	_	_	E	_	_	E	_	_	E	_	_	E	_	_	E	_	_	E	_	_	E	_	_	E	_	_	E	_
_	_	_	_	_	_	_	_	_	_	_	_	_	_	_	_	V	_	_	_	_	_	^	_	_	_	_	_	V	_	_	_	_	_	V	_	_	_	_	_	_	_	_	_	_	_	_	_	_	_	_	_	V	_	_	_	_	_	_	_	_	_	_	_	_	_	_	_	_	_	_	_	_	_	_	_	_	_	_	_	_	_	_	_	_	_	_	_	_	_
_	_	_	_	_	_	_	_	_	_	_	_	_	_	_	_	V	_	_	_	_	_	^	_	_	_	_	_	V	_	_	_	_	_	V	_	_	_	_	_	_	_	_	_	_	_	_	_	_	_	_	_	V	_	_	_	_	_	_	_	_	_	_	_	_	_	_	_	_	_	_	_	_	_	_	_	_	_	_	_	_	_	_	_	_	_	_	_	_	_
_	E	_	_	E	_	_	E	_	_	E	_	_	E	_	_	W	_	_	E	_	_	W	_	_	E	_	_	W	_	_	E	_	_	W	_	_	E	_	_	E	_	_	E	_	_	E	_	_	E	_	_	W	_	_	E	_	_	T	>	>	W	>	>	W	>	>	W	>	>	W	>	>	W	>	>	T	_	_	E	_	_	E	_	_	E	_	_	E	_
_	_	_	_	_	_	_	_	_	_	_	_	_	_	_	_	V	_	_	_	_	_	^	_	_	_	_	_	V	_	_	_	_	_	V	_	_	_	_	_	_	_	_	_	_	_	_	_	_	_	_	_	V	_	_	_	_	_	^	_	_	_	_	_	_	_	_	_	_	_	_	_	_	_	_	_	V	_	_	_	_	_	_	_	_	_	_	_	_	_
_	_	_	_	_	_	_	_	_	_	_	_	_	_	_	_	V	_	_	_	_	_	^	_	_	_	_	_	V	_	_	_	_	_	V	_	_	_	_	_	_	_	_	_	_	_	_	_	_	_	_	_	V	_	_	_	_	_	^	_	_	_	_	_	_	_	_	_	_	_	_	_	_	_	_	_	V	_	_	_	_	_	_	_	_	_	_	_	_	_
_	E	_	_	E	_	_	E	_	_	E	_	_	E	_	_	W	_	_	E	_	_	W	_	_	E	_	_	W	_	_	E	_	_	W	_	_	E	_	_	E	_	_	E	_	_	E	_	_	E	_	_	W	_	_	E	_	_	W	_	_	E	_	_	E	_	_	E	_	_	E	_	_	E	_	_	W	_	_	E	_	_	E	_	_	E	_	_	E	_
_	_	_	_	_	_	_	_	_	_	_	_	_	_	_	_	V	_	_	_	_	_	^	_	_	_	_	_	V	_	_	_	_	_	V	_	_	_	_	_	_	_	_	_	_	_	_	_	_	_	_	_	V	_	_	_	_	_	^	_	_	_	_	_	_	_	_	_	_	_	_	_	_	_	_	_	V	_	_	_	_	_	_	_	_	_	_	_	_	_
_	_	_	_	_	_	_	_	_	_	_	_	_	_	_	_	V	_	_	_	_	_	^	_	_	_	_	_	V	_	_	_	_	_	V	_	_	_	_	_	_	_	_	_	_	_	_	_	_	_	_	_	V	_	_	_	_	_	^	_	_	_	_	_	_	_	_	_	_	_	_	_	_	_	_	_	V	_	_	_	_	_	_	_	_	_	_	_	_	_
_	E	_	_	E	_	_	E	_	_	E	_	_	E	_	_	T	>	>	W	>	>	T	_	_	E	_	_	W	_	_	E	_	_	T	>	>	W	>	>>0	P5	<1	<	W	<	<	W	<	<	W	<	<	T	_	_	E	_	_	W	_	_	E	_	_	T	>	>	W	>	>>0	P7	<1	<	W	<	<	T	_	_	E	_	_	E	_	_	E	_	_	E	_
_	_	_	_	_	_	_	_	_	_	_	_	_	_	_	_	_	_	_	_	_	_	_	_	_	_	_	_	V	_	_	_	_	_	_	_	_	_	_	_	V0	_	_	_	_	_	_	_	_	_	_	_	_	_	_	_	_	_	^	_	_	_	_	_	^	_	_	_	_	_	V0	_	_	_	_	_	_	_	_	_	_	_	_	_	_	_	_	_	_	_
_	_	_	_	_	_	_	_	_	_	_	_	_	_	_	_	_	_	_	_	_	_	_	_	_	_	_	_	V	_	_	_	_	_	_	_	_	_	_	_	V	_	_	_	_	_	_	_	_	_	_	_	_	_	_	_	_	_	^	_	_	_	_	_	^	_	_	_	_	_	V	_	_	_	_	_	_	_	_	_	_	_	_	_	_	_	_	_	_	_
_	E	_	_	E	_	_	E	_	_	E	_	_	E	_	_	E	_	_	E	_	_	E	_	_	E	_	_	W	_	_	E	_	_	E	_	_	E	_	_	W	_	_	E	_	_	E	_	_	E	_	_	E	_	_	E	_	_	W	_	_	E	_	_	W	_	_	E	_	_	W	_	_	E	_	_	E	_	_	E	_	_	E	_	_	E	_	_	E	_
_	_	_	_	_	_	_	_	_	_	_	_	_	_	_	_	_	_	_	_	_	_	_	_	_	_	_	_	V	_	_	_	_	_	_	_	_	_	_	_	V	_	_	_	_	_	_	_	_	_	_	_	_	_	_	_	_	_	^	_	_	_	_	_	^	_	_	_	_	_	V	_	_	_	_	_	_	_	_	_	_	_	_	_	_	_	_	_	_	_
_	_	_	_	_	_	_	_	_	_	_	_	_	_	_	_	_	_	_	_	_	_	_	_	_	_	_	_	V	_	_	_	_	_	_	_	_	_	_	_	V	_	_	_	_	_	_	_	_	_	_	_	_	_	_	_	_	_	^	_	_	_	_	_	^	_	_	_	_	_	V	_	_	_	_	_	_	_	_	_	_	_	_	_	_	_	_	_	_	_
_	E	_	_	E	_	_	E	_	_	E	_	_	E	_	_	E	_	_	E	_	_	E	_	_	E	_	_	W	_	_	E	_	_	E	_	_	E	_	_	T	>	>	W	>	>	W	>	>	W	>	>	W	>	>	W	>	>	T	_	_	E	_	_	W	_	_	E	_	_	T	>	>	W	>	>0	P8	_	_	E	_	_	E	_	_	E	_	_	E	_
_	_	_	_	_	_	_	_	_	_	_	_	_	_	_	_	_	_	_	_	_	_	_	_	_	_	_	_	V	_	_	_	_	_	_	_	_	_	_	_	_	_	_	_	_	_	_	_	_	_	_	_	_	_	_	_	_	_	_	_	_	_	_	_	^	_	_	_	_	_	_	_	_	_	_	_	_	_	_	_	_	_	_	_	_	_	_	_	_	_
_	_	_	_	_	_	_	_	_	_	_	_	_	_	_	_	_	_	_	_	_	_	_	_	_	_	_	_	V	_	_	_	_	_	_	_	_	_	_	_	_	_	_	_	_	_	_	_	_	_	_	_	_	_	_	_	_	_	_	_	_	_	_	_	^	_	_	_	_	_	_	_	_	_	_	_	_	_	_	_	_	_	_	_	_	_	_	_	_	_
_	E	_	_	E	_	_	E	_	_	E	_	_	E	_	_	E	_	_	E	_	_	E	_	_	E	_	_	W	_	_	E	_	_	E	_	_	E	_	_	E	_	_	E	_	_	E	_	_	E	_	_	E	_	_	E	_	_	E	_	_	E	_	_	W	_	_	E	_	_	E	_	_	E	_	_	E	_	_	E	_	_	E	_	_	E	_	_	E	_
_	_	_	_	_	_	_	_	_	_	_	_	_	_	_	_	_	_	_	_	_	_	_	_	_	_	_	_	V	_	_	_	_	_	_	_	_	_	_	_	_	_	_	_	_	_	_	_	_	_	_	_	_	_	_	_	_	_	_	_	_	_	_	_	^	_	_	_	_	_	_	_	_	_	_	_	_	_	_	_	_	_	_	_	_	_	_	_	_	_
_	_	_	_	_	_	_	_	_	_	_	_	_	_	_	_	_	_	_	_	_	_	_	_	_	_	_	_	V	_	_	_	_	_	_	_	_	_	_	_	_	_	_	_	_	_	_	_	_	_	_	_	_	_	_	_	_	_	_	_	_	_	_	_	^	_	_	_	_	_	_	_	_	_	_	_	_	_	_	_	_	_	_	_	_	_	_	_	_	_
_	E	_	_	E	_	_	E	_	_	E	_	_	E	_	_	E	_	_	E	_	_	E	_	_	E	_	_	T	>	>	W	>	>	W	>	>	W	>	>	W	>	>	W	>	>	W	>	>	W	>	>	W	>	>	W	>	>	W	>	>	W	>	>	T	_	_	E	_	_	E	_	_	E	_	_	E	_	_	E	_	_	E	_	_	E	_	_	E	_
_	_	_	_	_	_	_	_	_	_	_	_	_	_	_	_	_	_	_	_	_	_	_	_	_	_	_	_	_	_	_	_	_	_	_	_	_	_	_	_	_	_	_	_	_	_	_	_	_	_	_	_	_	_	_	_	_	_	_	_	_	_	_	_	_	_	_	_	_	_	_	_	_	_	_	_	_	_	_	_	_	_	_	_	_	_	_	_	_	_
